%%%%%%%%%%%%%%%%%%%%
%.           ..%   %
%.%%.%%.%%.%%.%%%% %
%        P       % %
%%%%%%%%%%%%%%%%%% %
%.....             %
%%%%%%%%%%%%%%%%%%%%
